Maps/Identificators/Casa/Layer2.txt
0  0  0  0  0  0  0  0  0  0
0  0  0  0  0  0  0  16 0  0
0  0  0  0  0  0  0  17 0  0
0  0  0  0  0  0  0  0  0  0
0  0  0  0  0  0  0  0  0  0
0  1  4  7  10 13 0  0  0  0
0  2  5  8  11 14 0  0  0  0
0  3  6  9  12 15 0  0  0  0
0  0  0  0  0  0  0  0  0  0
0  0  0  0  0  0  0  0  0  0